#if defined(USE_TEX_ADDR)
extern unsigned short newmode_level_tex[];
void *newmode_level_tex_addr[] = {
#if defined(NON_PALETTE)
	0,
#else
	0,
#endif
#if defined(NON_TEXTURE)
	0,
#else
	newmode_level_tex,
#endif
};
#endif

#if defined(USE_TEX_SIZE)
unsigned short newmode_level_tex_size[] = { 48, 48, 16, 1, };
#endif

#if !defined(NON_TEXTURE)
unsigned short newmode_level_tex[] = {
0x0001,0x0001,0x0001,0x0001,0x0001,0x0001,0x0001,0x0001,0x0001,0x0001,0x0001,0x0001,0x0001,0x0001,0x0001,0x0001,0x0001,0x0001,0x0001,0x0001,0x0001,0x0001,0x0001,0x0001,0x0001,0x0001,0x0001,0x0001,0x0001,0x0001,0x0001,0x0001,0x0001,0x0001,0x0001,0x0001,0x0001,0x0001,0x0001,0x0001,0x0001,0x0001,0x0001,0x0001,0x0001,0x0001,0x0001,0x0001,
0x0001,0x0001,0x0001,0x0001,0x0001,0x0001,0x0001,0x0001,0x0001,0x0001,0x0001,0x0001,0x0001,0x0001,0x0001,0x0001,0x0001,0x0001,0x0001,0x0001,0x0001,0x0001,0x0001,0x0001,0x0001,0x0001,0x0001,0x0001,0x0001,0x0001,0x0001,0x0001,0x0001,0x0001,0x0001,0x0001,0x0001,0x0001,0x0001,0x0001,0x0001,0x0001,0x0001,0x0001,0x0001,0x0001,0x0001,0x0001,
0x0001,0x0001,0x0001,0x0001,0x0001,0x0001,0x0001,0x0001,0x0001,0x0001,0x0001,0x0001,0x084f,0x084f,0x0001,0x0001,0x20e3,0x292f,0x1097,0x0001,0x0001,0x0001,0x0001,0x0001,0x0001,0x0001,0x0001,0x0001,0x0001,0x0001,0x0001,0x0001,0x0001,0x0001,0x0001,0x0001,0x20e7,0x292f,0x1097,0x0001,0x0001,0x0001,0x0001,0x0001,0x0001,0x0001,0x0001,0x0001,
0x0001,0x0001,0x0001,0x0001,0x0001,0x0001,0x0001,0x0001,0x0001,0x0001,0x0001,0x104f,0x41bd,0x41ff,0x2927,0x20df,0x39b7,0x41bd,0x316f,0x20df,0x20df,0x20df,0x20df,0x0001,0x0001,0x0001,0x20df,0x41bd,0x41fd,0x41fd,0x41ff,0x41fd,0x41ff,0x41bf,0x41bd,0x41ff,0x41fd,0x41fd,0x20df,0x0001,0x0001,0x0001,0x0001,0x0001,0x0001,0x0001,0x0001,0x0001,
0x0001,0x0001,0x0001,0x0001,0x0001,0x0001,0x0001,0x0001,0x0001,0x0001,0x0005,0x39af,0x523f,0x523f,0x523d,0x523f,0x523f,0x523f,0x523f,0x523f,0x523f,0x523f,0x523f,0x0001,0x0001,0x0001,0x1893,0x39af,0x39af,0x39af,0x39af,0x49f7,0x523f,0x4a3b,0x39af,0x39af,0x39af,0x3167,0x104b,0x0001,0x0001,0x0001,0x0001,0x0001,0x0001,0x0001,0x0001,0x0001,
0x0001,0x0001,0x0001,0x0001,0x0001,0x0001,0x0001,0x0001,0x0001,0x0001,0x0005,0x62ff,0x62ff,0x315f,0x0001,0x0001,0x5233,0x62ff,0x39a7,0x0001,0x0001,0x0001,0x0001,0x0001,0x0001,0x0001,0x0001,0x0001,0x0001,0x0001,0x0001,0x39a7,0x62ff,0x5233,0x0001,0x0001,0x0001,0x0001,0x0001,0x0001,0x0001,0x0001,0x0001,0x0001,0x0001,0x0001,0x0001,0x0001,
0x0001,0x0001,0x0001,0x0001,0x0001,0x0001,0x0001,0x0001,0x0001,0x0001,0x0001,0x399f,0x18cf,0x0001,0x0001,0x0001,0x5aaf,0x737f,0x399f,0x0001,0x0001,0x0001,0x0001,0x0001,0x0001,0x0001,0x399f,0x737f,0x737f,0x737f,0x737f,0x737f,0x737f,0x737f,0x737f,0x737f,0x737f,0x737f,0x5aaf,0x0001,0x0001,0x0001,0x0001,0x0001,0x0001,0x0001,0x0001,0x0001,
0x0001,0x0001,0x0001,0x0001,0x0001,0x0001,0x0001,0x0001,0x0001,0x0001,0x0001,0x0001,0x0001,0x0001,0x0001,0x0001,0x7373,0x8c3f,0x52a7,0x0001,0x0001,0x0001,0x0001,0x0001,0x0001,0x0001,0x3197,0x6b2f,0x632f,0x6b2f,0x632f,0x7bb7,0x8c3f,0x83fb,0x632f,0x6b2f,0x632f,0x632f,0x4a63,0x0001,0x0001,0x0001,0x0001,0x0001,0x0001,0x0001,0x0001,0x0001,
0x0001,0x0001,0x0001,0x0001,0x0001,0x0001,0x0001,0x0001,0x0001,0x0001,0x0001,0x0001,0x9cbf,0x9cbf,0x9cbf,0x9cbf,0x9cbf,0x9cbf,0x9cbf,0x9cbf,0x9cbf,0x9cbf,0x9cbf,0x0001,0x0001,0x0001,0x0001,0x0001,0x0001,0x0001,0x0001,0x4a5f,0x9cbf,0x73af,0x0001,0x0001,0x0001,0x0001,0x0001,0x0001,0x0001,0x0001,0x0001,0x0001,0x0001,0x0001,0x0001,0x0001,
0x0001,0x0001,0x0001,0x0001,0x0001,0x0001,0x0001,0x0001,0x0001,0x0001,0x0001,0x0001,0x5a9f,0x5a9f,0x5a9f,0x5a9f,0x9cb7,0xb57f,0x842f,0x5a9f,0x5a9f,0x5a9f,0x5a9f,0x0001,0x0001,0x0001,0x842f,0xb57f,0xb57f,0xb57f,0xb57f,0xb57f,0xb57f,0xb57f,0xb57f,0xb57f,0xb57f,0xb57f,0x842f,0x0001,0x0001,0x0001,0x0001,0x0001,0x0001,0x0001,0x0001,0x0001,
0x0001,0x0001,0x0001,0x0001,0x0001,0x0001,0x0001,0x0001,0x0001,0x0001,0x0001,0x0001,0x0001,0x0001,0x0001,0x0001,0x94af,0xc63f,0x631f,0x0001,0x0001,0x0001,0x0001,0x0001,0x0001,0x0001,0x6b63,0x94af,0x94af,0x94af,0x94af,0xad77,0xc63f,0xbdbb,0x94af,0x94af,0x94af,0x94af,0x6b63,0x0001,0x0001,0x0001,0x0001,0x0001,0x0001,0x0001,0x0001,0x0001,
0x0001,0x0001,0x0001,0x0001,0x0001,0x0001,0x0001,0x0001,0x0001,0x0001,0x0001,0x0001,0x0001,0x0001,0x0001,0x0001,0xa4ef,0xd6bf,0x6b5f,0x0001,0x0001,0x0001,0x0001,0x0001,0x0001,0x0001,0x0001,0x0001,0x0001,0x0001,0x0001,0x7be3,0xd6bf,0xa4ef,0x0001,0x0001,0x0001,0x0001,0x0001,0x0001,0x0001,0x0001,0x0001,0x0001,0x0001,0x0001,0x0001,0x0001,
0x0001,0x0001,0x0001,0x0001,0x0001,0x0001,0x0001,0x0001,0x0001,0x0001,0x0001,0xe73f,0xe73f,0xef3f,0xe73f,0xe73f,0xe73f,0xef3f,0xef3f,0xe73f,0xef3f,0xe73f,0xe73f,0x739f,0x0001,0x0001,0x0001,0x0001,0x0001,0xe73f,0xef3f,0xe73f,0xe73f,0xad6f,0x0001,0x0001,0x0001,0x0001,0x0001,0x0001,0x0001,0x0001,0x0001,0x0001,0x0001,0x0001,0x0001,0x0001,
0x0001,0x0001,0x0001,0x0001,0x0001,0x0001,0x0001,0x0001,0x0001,0x0001,0x0001,0xbdf1,0xbdf1,0xbdef,0xbdf1,0xbdf1,0xbdf1,0xbdf1,0xbdf1,0xbdf1,0xbdf1,0xbdef,0xbdf1,0x5ad9,0x0001,0x0001,0x0001,0x0001,0x0001,0xbdef,0xbdef,0xbdf1,0xbdf1,0x39d1,0x0001,0x0001,0x0001,0x0001,0x0001,0x0001,0x0001,0x0001,0x0001,0x0001,0x0001,0x0001,0x0001,0x0001,
0x0001,0x0001,0x0001,0x0001,0x0001,0x0001,0x0001,0x0001,0x0001,0x0001,0x0001,0x0001,0x0001,0x0001,0x0001,0x0001,0x0001,0x0001,0x0001,0x0001,0x0001,0x0001,0x0001,0x0001,0x0001,0x0001,0x0001,0x0001,0x0001,0x0001,0x0001,0x0001,0x0001,0x0001,0x0001,0x0001,0x0001,0x0001,0x0001,0x0001,0x0001,0x0001,0x0001,0x0001,0x0001,0x0001,0x0001,0x0001,
0x0001,0x0001,0x0001,0x0001,0x0001,0x0001,0x0001,0x0001,0x0001,0x0001,0x0001,0x0001,0x0001,0x0001,0x0001,0x0001,0x0001,0x0001,0x0001,0x0001,0x0001,0x0001,0x0001,0x0001,0x0001,0x0001,0x0001,0x0001,0x0001,0x0001,0x0001,0x0001,0x0001,0x0001,0x0001,0x0001,0x0001,0x0001,0x0001,0x0001,0x0001,0x0001,0x0001,0x0001,0x0001,0x0001,0x0001,0x0001,
0x0001,0x0001,0x0001,0x0001,0x0001,0x0001,0x0001,0x0001,0x0001,0x0001,0x0001,0x0001,0x0001,0x0001,0x0001,0x0001,0x0001,0x0001,0x0001,0x0001,0x0001,0x0001,0x0001,0x0001,0x0001,0x0001,0x0001,0x0001,0x0001,0x0001,0x0001,0x0001,0x0001,0x0001,0x0001,0x0001,0x0001,0x0001,0x0001,0x0001,0x0001,0x0001,0x0001,0x0001,0x0001,0x0001,0x0001,0x0001,
0x0001,0x0001,0x0001,0x0001,0x0001,0x0001,0x0001,0x0001,0x0001,0x0001,0x0001,0x0001,0x0001,0x0001,0x0001,0x0001,0x0001,0x0001,0x0001,0x0001,0x0001,0x0001,0x0001,0x0001,0x0001,0x0001,0x0001,0x0001,0x0001,0x0001,0x0001,0x0001,0x0001,0x0001,0x0001,0x0001,0x0001,0x0001,0x0001,0x0001,0x0001,0x0001,0x0001,0x0001,0x0001,0x0001,0x0001,0x0001,
0x0001,0x0001,0x0001,0x0001,0x0001,0x0001,0x0001,0x0001,0x0001,0x0001,0x0001,0x0001,0x0001,0x7b83,0x7b83,0x0001,0x0001,0x0001,0x5a83,0x7b83,0x0001,0x0001,0x0001,0x0001,0x0001,0x0001,0x0001,0x0001,0x0001,0x0001,0x0001,0x0001,0x0001,0x0001,0x0001,0x0001,0x7b83,0x7b83,0x39c1,0x0001,0x0001,0x0001,0x0001,0x0001,0x0001,0x0001,0x0001,0x0001,
0x0001,0x0001,0x0001,0x0001,0x0001,0x0001,0x0001,0x0001,0x0001,0x0001,0x0001,0xf709,0xf709,0xf709,0xf709,0xf709,0xf709,0x9485,0xe689,0xf709,0xd647,0xb547,0xb547,0x0001,0x0001,0x0001,0x8c05,0xb547,0xb547,0xb547,0xb547,0xb547,0xb547,0xb547,0xb547,0xc5c7,0xf709,0xf709,0x7b85,0x0001,0x0001,0x0001,0x0001,0x0001,0x0001,0x0001,0x0001,0x0001,
0x0001,0x0001,0x0001,0x0001,0x0001,0x0001,0x0001,0x0001,0x0001,0x0001,0x18c5,0x18c5,0x18c5,0x18c5,0x18c5,0x18c5,0x18c5,0xa4c9,0xf74d,0xf70d,0xf70d,0xf70d,0xf70d,0x0001,0x0001,0x0001,0x7b87,0xf74d,0xf70d,0xf70d,0xf70d,0xf70d,0xf70d,0xf70d,0xf74d,0xf74d,0xf74d,0xc5cb,0x18c1,0x0001,0x0001,0x0001,0x0001,0x0001,0x0001,0x0001,0x0001,0x0001,
0x0001,0x0001,0x0001,0x0001,0x0001,0x0001,0x0001,0x0001,0x0001,0x0001,0x0001,0xf751,0xf751,0xf751,0xf751,0xf751,0xf751,0x4a45,0xc5cf,0xf751,0x0001,0xf751,0xf751,0x0001,0x0001,0x0001,0x0001,0x0001,0x0001,0x0001,0x0001,0xbd8d,0xf751,0xbd8d,0x0001,0x0001,0x0001,0x0001,0x0001,0x0001,0x0001,0x0001,0x0001,0x0001,0x0001,0x0001,0x0001,0x0001,
0x0001,0x0001,0x0001,0x0001,0x0001,0x0001,0x0001,0x0001,0x0001,0x0001,0x0001,0xf757,0xf757,0x18c5,0x18c5,0xf757,0xf751,0x7b8b,0xf757,0xf757,0xbd91,0xf757,0xf757,0x0001,0x0001,0x0001,0xbd91,0xf757,0xf757,0xf757,0xf757,0xf757,0xf757,0xf757,0xf757,0xf757,0xf757,0xf757,0x7b8b,0x0001,0x0001,0x0001,0x0001,0x0001,0x0001,0x0001,0x0001,0x0001,
0x0001,0x0001,0x0001,0x0001,0x0001,0x0001,0x0001,0x0001,0x0001,0x0001,0x0001,0xf75d,0xf75d,0xf75d,0xf75d,0xf75d,0xf75d,0x39c7,0xde99,0xf75d,0xef1b,0xf75d,0xf75d,0x0001,0x0001,0x0001,0x8c11,0xbd95,0xbd95,0xbd95,0xbd95,0xef1b,0xf75d,0xef1b,0xbd95,0xbd95,0xbd95,0xbd95,0x5acb,0x0001,0x0001,0x0001,0x0001,0x0001,0x0001,0x0001,0x0001,0x0001,
0x0001,0x0001,0x0001,0x0001,0x0001,0x0001,0x0001,0x0001,0x0001,0x0001,0x1043,0x0001,0x0001,0xde9f,0xffa3,0xce1d,0xce1d,0x1043,0xbd9b,0xffa3,0xffa3,0xffa3,0xffa3,0x0001,0x0001,0x0001,0x0001,0x0001,0x0001,0x0001,0x0001,0xbd9b,0xffa3,0xbd9b,0x0001,0x0001,0x0001,0x0001,0x0001,0x0001,0x0001,0x0001,0x0001,0x0001,0x0001,0x0001,0x0001,0x0001,
0x0001,0x0001,0x0001,0x0001,0x0001,0x0001,0x0001,0x0001,0x0001,0x0001,0x39cb,0xffa9,0xffa9,0xffa9,0xffa9,0xffa9,0xffa9,0x7bd5,0xef27,0xffa9,0x0001,0xffa9,0xffa9,0x4a4d,0x0001,0x0001,0xffa9,0xffa9,0xffa9,0xffa9,0xffa9,0xffa9,0xffa9,0xffa9,0xffa9,0xffa9,0xffa9,0xffa9,0xbddf,0x0001,0x0001,0x0001,0x0001,0x0001,0x0001,0x0001,0x0001,0x0001,
0x0001,0x0001,0x0001,0x0001,0x0001,0x0001,0x0001,0x0001,0x0001,0x0001,0x0001,0x0001,0xad61,0xffaf,0xef6b,0xffa9,0x0001,0x7bd7,0xffaf,0xffaf,0x0001,0xffaf,0xffaf,0x7bd7,0x0001,0x0001,0xbde3,0xbde3,0xbde3,0xbde3,0xbde3,0xef6b,0xffaf,0xef6d,0xbde3,0xbde3,0xbde3,0xbde3,0x8c5b,0x0001,0x0001,0x0001,0x0001,0x0001,0x0001,0x0001,0x0001,0x0001,
0x0001,0x0001,0x0001,0x0001,0x0001,0x0001,0x0001,0x0001,0x0001,0x0001,0x0001,0x62d3,0xdeed,0xfff5,0xad65,0xffa9,0x20c7,0x9ce1,0xbde7,0x0001,0x0001,0x0001,0x0001,0x20c7,0x0001,0x0001,0x0001,0x0001,0x0001,0x0001,0x0001,0xbde7,0xfff5,0xbde7,0x0001,0x0001,0x0001,0x0001,0x0001,0x0001,0x0001,0x0001,0x0001,0x0001,0x0001,0x0001,0x0001,0x0001,
0x0001,0x0001,0x0001,0x0001,0x0001,0x0001,0x0001,0x0001,0x0001,0x0001,0x0001,0xfff9,0xfff9,0x0001,0xfff9,0xfff9,0xdef3,0xe6f1,0xfff9,0xef75,0xce6f,0xfff9,0xfff9,0x6315,0x0001,0x0001,0x0001,0x0001,0x0001,0xbdeb,0xbdeb,0xfff9,0xfff9,0xbdeb,0x0001,0x0001,0x0001,0x0001,0x0001,0x0001,0x0001,0x0001,0x0001,0x0001,0x0001,0x0001,0x0001,0x0001,
0x0001,0x0001,0x0001,0x0001,0x0001,0x0001,0x0001,0x0001,0x0001,0x0001,0x0001,0xfffd,0xad69,0x1083,0x0001,0xf779,0xfffd,0x0001,0xe735,0xfffd,0x0001,0xbded,0xfffd,0x7bdf,0x0001,0x0001,0x0001,0x0001,0x0001,0xfffd,0xfffd,0xfffd,0xef79,0x5293,0x0001,0x0001,0x0001,0x0001,0x0001,0x0001,0x0001,0x0001,0x0001,0x0001,0x0001,0x0001,0x0001,0x0001,
0x0001,0x0001,0x0001,0x0001,0x0001,0x0001,0x0001,0x0001,0x0001,0x0001,0x0001,0x0001,0x0001,0x0001,0x0001,0x0001,0x0001,0x0001,0x0001,0x0001,0x0001,0x0001,0x0001,0x0001,0x0001,0x0001,0x0001,0x0001,0x0001,0x0001,0x0001,0x0001,0x0001,0x0001,0x0001,0x0001,0x0001,0x0001,0x0001,0x0001,0x0001,0x0001,0x0001,0x0001,0x0001,0x0001,0x0001,0x0001,
0x0001,0x0001,0x0001,0x0001,0x0001,0x0001,0x0001,0x0001,0x0001,0x0001,0x0001,0x0001,0x0001,0x0001,0x0001,0x0001,0x0001,0x0001,0x0001,0x0001,0x0001,0x0001,0x0001,0x0001,0x0001,0x0001,0x0001,0x0001,0x0001,0x0001,0x0001,0x0001,0x0001,0x0001,0x0001,0x0001,0x0001,0x0001,0x0001,0x0001,0x0001,0x0001,0x0001,0x0001,0x0001,0x0001,0x0001,0x0001,
0x0001,0x0001,0x0001,0x0001,0x0001,0x0001,0x0001,0x0001,0x0001,0x0001,0x0001,0x0001,0x0001,0x0001,0x0001,0x0001,0x0001,0x0001,0x0001,0x0001,0x0001,0x0001,0x0001,0x0001,0x0001,0x0001,0x0001,0x0001,0x0001,0x0001,0x0001,0x0001,0x0001,0x0001,0x0001,0x0001,0x0001,0x0001,0x0001,0x0001,0x0001,0x0001,0x0001,0x0001,0x0001,0x0001,0x0001,0x0001,
0x0001,0x0001,0x0001,0x0001,0x0001,0x0001,0x0001,0x0001,0x0001,0x0001,0x0001,0x0001,0x0001,0x0001,0x0001,0x0001,0x0001,0x0001,0x0001,0x0001,0x0001,0x0001,0x0001,0x0001,0x0001,0x0001,0x0001,0x0001,0x0001,0x0001,0x0001,0x0001,0x0001,0x0001,0x0001,0x0001,0x0001,0x0001,0x0001,0x0001,0x0001,0x0001,0x0001,0x0001,0x0001,0x0001,0x0001,0x0001,
0x0001,0x0001,0x0001,0x0001,0x0001,0x0001,0x0001,0x0001,0x0001,0x0001,0x0001,0x0001,0x0001,0x0001,0x0001,0x0001,0x58c1,0x6101,0x48c1,0x0001,0x0001,0x0001,0x0001,0x0001,0x0001,0x0001,0x0001,0x0001,0x0001,0x0001,0x0001,0x0001,0x0001,0x0001,0x0001,0x0001,0x4081,0x6101,0x48c1,0x0001,0x0001,0x0001,0x0001,0x0001,0x0001,0x0001,0x0001,0x0001,
0x0001,0x0001,0x0001,0x0001,0x0001,0x0001,0x0001,0x0001,0x0001,0x0001,0x0001,0xca47,0xca47,0xca47,0xca47,0xca47,0xca47,0xca47,0xca47,0xca47,0xca47,0xca47,0xca47,0x0001,0x0001,0x0001,0x6103,0xca47,0xca47,0xca47,0xca47,0xca47,0xca47,0xca47,0xca47,0xca47,0xca47,0xca47,0x99c5,0x0001,0x0001,0x0001,0x0001,0x0001,0x0001,0x0001,0x0001,0x0001,
0x0001,0x0001,0x0001,0x0001,0x0001,0x0001,0x0001,0x0001,0x0001,0x0001,0x0001,0x0001,0x0001,0x0001,0x0001,0x0001,0x0001,0x0001,0x0001,0x0001,0x0001,0x0001,0x0001,0x0001,0x0001,0x0001,0x4081,0x9a09,0x9a09,0x9a09,0x9a09,0xba89,0xd2cb,0xd2cb,0x9a09,0x9a09,0x9a09,0x9a09,0x0001,0x0001,0x0001,0x0001,0x0001,0x0001,0x0001,0x0001,0x0001,0x0001,
0x0001,0x0001,0x0001,0x0001,0x0001,0x0001,0x0001,0x0001,0x0001,0x0001,0x0001,0x0001,0xd351,0xd351,0xd351,0xd351,0xd351,0xd34f,0xd351,0xd351,0xd351,0xd351,0x0001,0x0001,0x0001,0x0001,0x0001,0x0001,0x0001,0x0001,0x0001,0x6989,0xd351,0x6989,0x0001,0x0001,0x0001,0x0001,0x0001,0x0001,0x0001,0x0001,0x0001,0x0001,0x0001,0x0001,0x0001,0x0001,
0x0001,0x0001,0x0001,0x0001,0x0001,0x0001,0x0001,0x0001,0x0001,0x0001,0x0001,0x0001,0xdbd5,0xdbd5,0x0001,0x0001,0x0001,0x0001,0x0001,0x0001,0x928f,0xdbd5,0x0001,0x0001,0x0001,0x0001,0xa2d1,0xdbd5,0xdbd5,0xdbd5,0xdbd5,0xdbd5,0xdbd5,0xdbd5,0xdbd5,0xdbd5,0xdbd5,0xdbd5,0xa2d1,0x0001,0x0001,0x0001,0x0001,0x0001,0x0001,0x0001,0x0001,0x0001,
0x0001,0x0001,0x0001,0x0001,0x0001,0x0001,0x0001,0x0001,0x0001,0x0001,0x0001,0x0001,0xab55,0xab55,0xab55,0xab55,0xab55,0xab55,0xab55,0xab55,0xab55,0xab55,0x0001,0x0001,0x0001,0x0001,0x7a8f,0xab55,0xab55,0xab55,0xab55,0xc3d9,0xdc5b,0xab55,0xab55,0xab55,0xab55,0xab55,0x7a8f,0x0001,0x0001,0x0001,0x0001,0x0001,0x0001,0x0001,0x0001,0x0001,
0x0001,0x0001,0x0001,0x0001,0x0001,0x0001,0x0001,0x0001,0x0001,0x0001,0x0001,0xabd9,0xe521,0xe521,0xe521,0xe521,0xe521,0xe521,0xe521,0xe521,0xe521,0xe521,0xe521,0x0001,0x0001,0x0001,0x0001,0x0001,0x0001,0x0001,0x0001,0x7291,0xe521,0x7291,0x0001,0x0001,0x0001,0x0001,0x0001,0x0001,0x0001,0x0001,0x0001,0x0001,0x0001,0x0001,0x0001,0x0001,
0x0001,0x0001,0x0001,0x0001,0x0001,0x0001,0x0001,0x0001,0x0001,0x0001,0x0001,0xb45f,0xeda9,0x4107,0x0001,0x0001,0x0001,0x0001,0x0001,0x0001,0x0001,0xe521,0xeda7,0x0001,0x0001,0x0001,0xb41f,0xeda9,0xeda9,0xeda7,0xeda9,0xeda9,0xeda9,0xeda9,0xeda9,0xeda9,0xeda9,0xeda9,0xeda7,0x0001,0x0001,0x0001,0x0001,0x0001,0x0001,0x0001,0x0001,0x0001,
0x0001,0x0001,0x0001,0x0001,0x0001,0x0001,0x0001,0x0001,0x0001,0x0001,0x0001,0xb4a3,0xf62f,0x0001,0xf62f,0xee6f,0xee6f,0xf66f,0xf62f,0xf66f,0x0001,0xf66f,0xf66f,0x0001,0x0001,0x0001,0x839b,0xb4a3,0xb4a3,0xb4a3,0xb4a3,0xd569,0xee2f,0xb4a3,0xb4a3,0xb4a3,0xb4a3,0xb4a3,0xb4a3,0x0001,0x0001,0x0001,0x0001,0x0001,0x0001,0x0001,0x0001,0x0001,
0x0001,0x0001,0x0001,0x0001,0x0001,0x0001,0x0001,0x0001,0x0001,0x0001,0x0001,0xbd27,0xf6f3,0x0001,0xf6f3,0xf6f3,0x0001,0x0001,0xf6f3,0xf6f3,0x0001,0xf6f3,0xf6f3,0x0001,0x0001,0x0001,0x0001,0x0001,0x0001,0x0001,0x0001,0x7b59,0xf6f3,0xb4a3,0x0001,0x0001,0x0001,0x0001,0x0001,0x0001,0x0001,0x0001,0x0001,0x0001,0x0001,0x0001,0x0001,0x0001,
0x0001,0x0001,0x0001,0x0001,0x0001,0x0001,0x0001,0x0001,0x0001,0x0001,0x0001,0xbd6b,0xff79,0x0001,0xff79,0xff79,0x0001,0x0001,0xff79,0xff79,0x0001,0xff79,0xff79,0x0001,0x0001,0x0001,0x0001,0x0001,0x0001,0xb4a3,0xb4a3,0xb4a3,0xff79,0xb4a3,0x0001,0x0001,0x0001,0x0001,0x0001,0x0001,0x0001,0x0001,0x0001,0x0001,0x0001,0x0001,0x0001,0x0001,
0x0001,0x0001,0x0001,0x0001,0x0001,0x0001,0x0001,0x0001,0x0001,0x0001,0x0001,0xac1f,0xac1f,0x0001,0xac1f,0xac1f,0xac1f,0xac1f,0xac1f,0xac1f,0x0001,0xac1f,0xac1f,0x0001,0x0001,0x0001,0x0001,0x0001,0x0001,0x7bdf,0xffbd,0xffbd,0xef79,0x7bdf,0x0001,0x0001,0x0001,0x0001,0x0001,0x0001,0x0001,0x0001,0x0001,0x0001,0x0001,0x0001,0x0001,0x0001,
0x0001,0x0001,0x0001,0x0001,0x0001,0x0001,0x0001,0x0001,0x0001,0x0001,0x0001,0x0001,0x0001,0x0001,0x0001,0x0001,0x0001,0x0001,0x0001,0x0001,0x0001,0x0001,0x0001,0x0001,0x0001,0x0001,0x0001,0x0001,0x0001,0x0001,0x0001,0x0001,0x0001,0x0001,0x0001,0x0001,0x0001,0x0001,0x0001,0x0001,0x0001,0x0001,0x0001,0x0001,0x0001,0x0001,0x0001,0x0001,
0x0001,0x0001,0x0001,0x0001,0x0001,0x0001,0x0001,0x0001,0x0001,0x0001,0x0001,0x0001,0x0001,0x0001,0x0001,0x0001,0x0001,0x0001,0x0001,0x0001,0x0001,0x0001,0x0001,0x0001,0x0001,0x0001,0x0001,0x0001,0x0001,0x0001,0x0001,0x0001,0x0001,0x0001,0x0001,0x0001,0x0001,0x0001,0x0001,0x0001,0x0001,0x0001,0x0001,0x0001,0x0001,0x0001,0x0001,0x0001,
};
#endif

